AatII	GACGTC	GAC'GTC
Acc65I	GGTACC	GGTAC'C
AjiI	CACGTC	CAC'GTC
AluI	AGCT	AG'CT
Alw44I	GTGCAC	G'TGCAC
ApaI	GGGCCC	GGGCC'C
BamHI	GGATCC	G'GATCC
BclI	TGATCA	T'GATCA
BcuI	ACTAGT	A'CTAGT
BglII	AGATCT	A'GATCT
BshTI	ACCGGT	A'CCGGT
Bsp119I	TTCGAA	TT'CGAA
Bsp120I	GGGCCC	G'GGCCC
Bsp1407I	TGTACA	T'GTACA
Bsp143I	GATC	G'ATC
Bsp68I	TCGCGA	TCG'CGA
BspOI	GCTAGC	G'CTAGC
BspTI	CTTAAG	C'TTAAG
Bst1107I	GTATAC	GTA'TAC
BstBI	TTCGAA	TT'CGAA
BSU15I	ATCGAT	AT'CGAT
BsuRI	GGCC	GG'CC
Cfr42I	CCGCGG	CCGC'GG
Cfr9I	CCCGGG	C'CCGGG
Csp6I	GTAC	G'TAC
DraI	TTTAAA	TTT'AAA
Ecl136II	GAGCTC	GAG'CTC
Eco147I	AGGCCT	AGG'CCT
Eco32I	GATATC	GAT'ATC
Eco47III	AGCGCT	AGC'GCT
ECO52I	CGGCCG	C'GGCCG
Eco72I	CACGTG	CAC'GTG
EcoRI	GAATTC	G'AATTC
Hin6I	GCGC	GCG'C
HindIII	AAGCTT	A'AGCTT
HpaII	CCGG	C'CGG
Kpn2I	TCCGGA	T'CCGGA
KpnI	GGTACC	GGTAC'C
KspAI	GTTAAC	GTT'AAC
MauBI	CGCGCGCG	CG'CGCGCG
MlsI	TGGCCA	TGG'CCA
MluI	ACGCGT	A'CGCGT
Mph1103I	ATGCAT	ATGCA'T
MspI	CCGG	C'CGG
MssI	GTTTAAAC	GTTT'AAAC
MunI	CAATTG	C'AATTG
NcoI	CCATGG	C'CATGG	
NdeI	CATATG	 CA'TATG
NheI	GCTAGC	GCTAG'C
NotI	GCGGCCGC	GC'GGCCGC
NsbI	TGCGCA	TGC'GCA
PaeI	GCATGC	GCATG'C
PagI	TCATGA	T'CATGA
PauI	GCGCGC	G'CGCGC
PdiI	GCCGGC	GCC'GGC
PmeI	GTTTAAAC	GTTT'AAAC
Psp1406I	AACGTT	AA'CGTT
PstI	CTGCAG	CTGCA'G
PvuI	CGATCG	CGAT'CG
PvuII	CAGCTG	CAG'CTG
SacI	GAGCTC	GAGCT'C
SacII	CCGCGG	CCGC'GG
SalI	GTCGAC	G'TCGAC
ScaI	AGTACT	AGT'ACT
SdaI	CCTGCAGG	CCTGCA'GG
SgsI	GGCGCGCC	GG'CGCGCC
SmaI	CCCGGG	CCC'GGG
SmiI	ATTTAAAT	ATTT'AAAT
SspI	AATATT	AAT'ATT
TaqI	TCGA	T'CGA
Tru1I	TTAA	T'TAA
VspI	ATTAAT	AT'TAAT
XbaI	TCTAGA	T'CTAGA
XhoI	CTCGAG	C'TCGAG
